a  啊
an  俺
bu  不
di	的
geo	個
gue 國
gue-ja 國家
guo 過
huo	和
ja 家
je	幾個
ji	給
ji	幾
kau	＊
lai	來
le	嘞
lia	倆
liau	了
na	那
nen 您
ni	你
nia 人家
no	那個
o	哦
rhen	人
sa	仨
sha	啥
shei    誰
shui    誰
shy 是
ta  他
wo	我
yi	一
yo	一個
za	咋
zheo	這
ziou	就
zho	這個
zhung	中
zhung	種
zhung-gue   中國
zhung-gue-rhen   中國人
zua	做啥
